1111111111111111111
1P010C0000000000011
111100E000000000001
1111000000000000001
1111111111111111111
